700
DXXVI	MCXXIII
DXXI	MDCXLI
CIX	MDCLXXXI
MCDXXVI	MCMLXX
MCCCXLV	CCCLI
MCDII	DCCLXXVII
CCCXLVIII	DCLXVIII
MCMXIX	MDXXXVIII
MCLXVIII	CCCXLVIII
MCDLXXVI	MDCCCLXXXV
CLXXIII	MDXLIX
MDCCXXXVIII	MDXLIX
CCCLXXIX	CCLXXXIV
MDCCCXLI	DXXXIX
CCXIX	MDCCCVII
MCCXXIV	CMLXXXVIII
MDLX	MCMLXXII
MDCCLXXXVI	MCLI
MLVI	MCDLVII
CCCLXXXVIII	MCXLVIII
CCIV	MDCCXLV
MCLIV	MDLXIV
DCCLVI	CCLI
MCDLIV	DCCCXCV
MCCXXXI	DCCCLXII
MCXXV	DCCCLXV
MDCCCLXIV	MCCCXLV
LXXIV	CDLXV
CMLXI	MDCLV
CCCXLV	MCMXLVI
CCXXIII	MDCXXVIII
CLXVIII	CCCXCIII
MDCLXXXIX	CCCXX
DCCCLIV	CDXII
DCCCXXXVI	CCXXIV
MCCCLXXV	MCDXXXVIII
MCCLXXI	MCMXL
CDXLIV	DLXXXV
DCLII	XV
MCDLXXXII	DCCLX
DCCL	DLXXII
MCMXXI	CCXLV
DCCLXXVI	CXX
CLXXXVII	CDXXIII
MCDXXXIX	MDCCCLV
MCCLX	MCLV
MCXLV	MCDLXXXII
CXCI	MDCCCXXVI
MCMXIII	MXLVII
MDXX	CDLXXVII
MCI	MCMXCVII
DCCLVIII	C
MDXXX	MDLVII
DLXXXII	CCIX
DCCLXIII	DCCLXXXI
CMXCVIII	CCCLVI
CII	MCCLXII
MCLXXII	CCCXXXVI
DCCIX	DCCLI
MDCLIII	MCMLV
CCLXXXIII	MCCCLXXIX
MCCCXCI	CXCII
DXXXIX	MXVII
MXCVIII	MDCCLVII
DLIX	CCXCVII
MCCXXXII	MDCXVII
DCCXVI	CCCXLV
CMLV	MCMLVII
CMLIV	MDLI
MLVI	MDCXXIII
CCLXXXVIII	CCXXXVI
MCCXXXII	MCDXXXIII
MCCCXLVI	MDCLXXIII
MDLXXXI	MCCCXXXI
MXLIV	MDCXIV
DCCLVII	MCCCXXIII
CCCLXXI	DCXXVI
MDCCCXXXVIII	MDCCLXXIII
LVI	MDCC
MDCCLXVIII	DCCLXXVII
DCCLXXXVI	DCLXVIII
MCDXLI	MCXVII
MDCXXVII	CXX
CLXXIX	MCMLXXIX
DCCXVII	MCCCXLVIII
MCMLXIII	DCCCXXXIII
DXCI	MXIII
LXXVIII	MDCCCLXX
VI	DCCCVII
VIII	MIX
CXL	DCCXVIII
MDCXXIV	CDLVII
MDCCCL	CLXXXVIII
MDLXXIX	DCLXXVI
CCCLX	CMLXIX
MDXIX	DCLVII
MDXLV	LXXII
MDCCXIII	MCMXIX
DCCCXXII	DCLXXXIX
DCCXLVIII	MCDXXV
DCCCXIV	MCMXXX
DCVI	MCMXXXIV
DCCXXI	CCCXCVII
DCCCLXXII	MDCCLXXIV
MCCCLVII	MDCCCLXX
MCXIV	MDCXXXVII
MCCCLI	DLXXV
MDCCLXII	MCCXCVII
MLXIX	MCCXVI
MDV	MCMXIII
MDCLXXVIII	MDCCLXXXVIII
DCCCXCVIII	CCCXLI
CCCLXXVIII	DCCLXXIV
MCMLXXXIV	MXCIV
DLVI	MCMIII
CCCLXX	MXIX
DCCCLXXIV	MDCCLXXVI
CXXXI	MDVIII
DCI	MCCLXXXIV
MCCCLXXIX	CMLXVI
MDCCCXXXV	MCCCLXXIV
MCLXXVIII	MDCCI
MDCCCXIII	MDCCXXI
MCDIII	MD
MCDLV	DCCLXXXVI
MDCIX	CCCXV
XLIII	CXXXIX
DXIII	LXI
CCCLXXIX	DXXXII
MDCCCVII	CC
MCMLXXXVII	MDXVII
MDXXXVI	MCMXLVI
CDXCVIII	DLXXXVIII
MCCXVIII	MCCCXXIV
CCCXCIX	MCCCXIV
DCLXXX	MCDLI
MDCCCXLII	MCDLXXI
XXXIX	MDCLXXIII
DCCCLXXVII	XIV
MDCCCLXX	DCCLVIII
DCCCLXXX	MCDXLI
CDVI	DCCLI
MXXII	MCXXIX
MCXCV	MXLIV
DXLVIII	CCCXVII
CCCXXVII	DCCXL
DCCLXXV	CDLVIII
DCCCXLIII	MXLV
CCCV	DCCXCIX
MCXII	CCXXXIV
CMLI	LI
XCIII	MCMXCIX
MCLVIII	MDXCV
MCIV	DCCXVIII
MCXVIII	MCCLXVI
MDCCCXXI	DLXX
CCCXXXV	CXXI
CDX	CCCXCIV
DCCCII	MCDXCI
CCXL	MCMXCIX
XXVII	MIII
CCLXIX	MCLI
MV	CCCLX
MXXX	XCVIII
MCLXXV	MCXLII
CDLV	DCCCXLVI
CLVII	DCCCXXIV
MDCCCLXI	DXIX
MLIV	MCMIX
MCMXXII	MDCLXXXI
CDLXXXII	CDLVIII
MCCXLIV	CMLXXVI
DXCI	MCMIII
MDCCCL	DCXCI
DCCVIII	CCLXXIV
CMXLVIII	DXCVI
DLXXXVIII	XI
MCCLXXXVII	MXXV
DXC	CCCLXXXVIII
DCXLII	MCDLXV
MDCCCXIII	MXXVI
CCXLVI	CCLXXI
MDCXIV	MCCXLIV
MDCCCLXXXI	MCCCLXXXIII
DLV	DCCCXCIV
MDCLXXXVIII	CDXXII
MCCXLIX	MCL
MCCCXXXIX	CCI
MDCCXII	MIII
MVII	MCDXXI
MCMXLVII	MCMXV
DCCCXL	MCDXVI
CMLXXV	MCL
MCDXLVII	MDCXXV
LXIX	MDCXCIII
MDCCCXCVIII	CDLXV
MDXXXIX	DXC
DCCCXI	MCMXIV
CDLXXXI	DCCII
DCLXXXIV	DCCCLXXXIII
CMIX	MDXXVIII
MLXXVII	CMV
MCLXXVIII	CMXCVIII
DCCLVII	DCCCXXIV
MCDXLI	MDCCCLXXXIII
DCCXCI	CCCLXV
DLI	LXXVI
CDXV	MDCCLXXIII
MCLXXXI	CCXLVI
MDXVI	MCMLXI
DCXXVII	CCCXXII
MCXXV	CCXXIV
CCXXXVI	MDCCXCIV
MDCCLVI	MLXXVIII
CDXXII	MDCLXXVI
IX	MDXXX
CXCVI	CCCXLV
DCCCXLIV	DCCLXXVI
MCCCXXIX	CXXIV
CCCLXXII	DCXIX
CXXXVIII	MCCCXXXIII
CDLXIII	CDLXXXIII
CLXXIX	DCCXXXV
MDCCCLXXVII	CCCXXXIX
CCLXXVIII	MCCCXLII
MDCCCXCIII	MDCLXVII
MDCXXIII	CLXXXVI
CCCLVI	MDXXXII
MCXXII	DCLXXX
MDCCCXCVIII	L
DLXXII	DX
MDXCII	CLXXVII
CMVIII	CMLXIV
MCCCXIV	MDCCLXXVII
MCMXXXVII	MDCCCII
DCCVII	LXXXVII
MDCCCLXI	DXII
MCDXCVII	MCMLXXV
DCXCVII	XLI
MDCCCXLIII	DCCCLXVI
MCXC	MDCCCLV
MDXXXVI	CMXCIII
MDLXXXIX	MLXXIV
MDCXLII	MCDVI
MCCCLXXXV	MCLXIV
MXIII	MCXLIX
MCCVII	CCCLI
CDVIII	DCCCXLVI
CCXCII	CMLXXXV
CCXXVI	MDIX
DCCCXLVI	XXXVI
MCMLV	CCLXIX
MDCCCXXIX	MLXXXIV
MDCIV	CLXXVIII
CMLXXVI	CDXXXII
MDCCCII	CCCLXXXIII
MDCCCXXXIV	MCCXCIX
DXXXVII	CCLXI
CCV	MDCLI
DCCL	MCDXII
MXLIV	CMLXVII
MXXVI	XXXVII
MDXXXVI	DCCCXLIV
I	MDXXX
MDCCLXVIII	MXCVIII
CDXXXVII	CXXXIX
DCCCVII	MCCLXXVI
DCLXXXVII	CXIII
CDLIV	CCXXXV
DCCLXXXI	DCCXI
MCCCXXV	XVIII
MDCCCLXVIII	MDXCIX
CCXIII	CDLXII
MDCXLIX	CXLVI
DLXXIV	DCCLXXXI
MDCCXVIII	MDCLXIV
MCLXIX	MDCLXXVI
DCXLVII	MXVII
MII	MCCCLIV
MDCCCXLV	CCXII
CXV	DCCCIII
CMXVI	DCCXXXVIII
MXCVII	MDLXXIX
MCXLIII	DCCXLII
MDCCXVI	DCCCXXV
XLVI	MX
MDCCXVI	CCXXXI
MDCCCXXV	MDXXXIII
CMIII	CCXXVI
DCCCXIV	DCCLXIV
DLXXXIII	MDLXXXI
MDCCCXLVI	DCCLXXXVIII
MDCCCXXXI	DCCX
DCCCXXXIX	CXXIII
DCXLVIII	MDCCCLXVII
CMXXXIII	CDXC
MCDLXII	DVII
MLIV	DCCLXXXIX
MLX	MDXI
MDCCXLVIII	CXLII
MDCCLXVI	DIV
MCMLXXVI	CDXLVIII
CDXXXVII	MCCCLXXIV
MCDIX	MDCXLVI
DXVII	DCX
MXCI	DCLXXIV
DL	MCLXXII
MCCCXLVII	MCXX
DCCXXII	CDLXXXIII
MCCXXIII	MCCLVII
MDXCIX	DCCCXLVI
MXLII	MDCCXXXV
CXXXVI	MDXXXV
MCLXVI	MCLXIX
DCLX	MXVI
MCCLXXII	MDCX
MCMLXIX	MDLXXXV
MCXXXVII	CDLX
CXLI	CCXLII
MXCVIII	CMLXIII
DCLXXXVI	XV
CCCXX	MDCCCXVI
MCDVIII	MDCCCLXXX
MCXLVIII	DCCCXVI
CMLXIV	XXXVII
MDCLXI	LXXXII
MLXXIII	DVIII
CMXXIV	CCCXL
DCCCXCV	MCCCLXXXVI
MLXXIX	DLXXXI
DCCCLIX	CMXIII
MDCCC	MCCXVIII
MXXXVII	MLXVI
CXXIV	MCDLXXI
CLIII	MCCCLXXXVI
DCCXXI	MDCXIV
XLVIII	MCDXCVII
MLXV	CDXCVIII
DCCLXXIV	MCXCI
MDCXL	DIV
MCMXV	MDCCLXI
CDXIII	DLIII
CDLXIX	MCLXXXV
DCCCXXVIII	MCCXXXVI
DLIII	MCCLXXII
XI	XCII
MCDXCVI	MCCCXII
DCCXLVIII	MLI
CDXXXVII	CCLXXVI
CXL	MDCCXCV
XXIV	LXXV
MDCCCXLI	CCIV
MCCCLXXXVIII	DCCXCIII
DCCCLVII	DCXLVIII
MCLXVII	CMXLIII
MCCXCIX	MXL
MCDXCVI	DCCCXXX
XXXVI	MDCCCXCVIII
DLXXVIII	MCCLVIII
DXXXVIII	MDCCCXCIV
MCDXC	MDCCCXCIII
MDCLXII	MCDX
MCXXVII	DCCLXV
MCXVI	MCCCLIII
MCLVII	MDCCCLVII
MCCCXLVIII	CMLVIII
MDCXXIV	DCCLXXV
MDCCCXXXV	MCV
MDXCVIII	CDXLIV
MCCCIII	MDCCCXCIII
CMXIV	MCMLI
CLXXXII	DXX
MCXCVII	MDCCXXX
LXXXIII	DCCCXXXIII
MXCIII	MCMXLIV
DCCCXIV	DCCCXIII
MDCCXXIX	MCXXX
CCCLXXVII	CCXXXIX
CXXXVI	MDCCCLXXIII
MDI	CCCLII
DCCCLXXXVIII	MCDXXX
DLXXXV	MCDI
MCCCXIX	CCXXXIII
DCLXXXIII	DCCXII
MCMLIII	MDXII
DXXVII	DCLIV
MLIII	MCCLI
MDCCCXXXV	DXLII
MCMLIV	CCXCIX
MDCC	DCCLIII
MDLXXXV	CDLXXIV
CMVIII	MCCLXX
CCCLXXIII	MDCII
MDCCLIV	CCCLXV
MDCLXXXVI	LXX
LXVII	DCCXLVIII
LIII	MLXVIII
MCMLXXXI	CDXLIX
XCIV	CCXLIV
MDLXXIX	MIV
MCDLXXXIX	CCCXL
MDCCCXCIII	MDCCLXII
MCMXXX	DXIV
MDCCCXXIII	MDCXLIX
MCXLVI	MCCLXV
MCDLXXXII	MDXXXIV
DCXIII	MDCCXXIX
CMXL	MDCCLXXII
DCCIX	MLXXII
CCVI	CMXLIV
MCMXVI	MCXIX
MLIII	CXLIX
CMXXVII	MLXII
CC	DCCLII
CDXIV	MDXL
MCLXX	CDLVI
DCCCXLII	MCCXLI
MXVI	CCCXXIV
MCCXXIX	MDIII
CLXXVI	DCCXXIV
DCLXVI	CDXCIV
XLVII	CDXCI
CXL	DCXXV
MCDIV	CXLIX
DCCXXXI	DCCCXXXIII
CDXXI	MCMVIII
MCCXXIV	DCLXVI
DCXLIII	CCCXXXIX
DCCCXLIX	DCXXXI
MDCCLIV	MDXCIX
DCCCXVIII	MDCCXXXIV
DCCLXXVIII	DCXXXII
MDCCCXXIII	MCDVI
CCXLV	MDCCLIX
DLXX	MCCCL
MDCCLXXXIII	CDXIII
MCCCLVII	MCCLXIX
MDCCCVI	DXCI
MDCCXCIV	MDCXXIX
DX	CCCIX
DXIX	MDCCLI
MDCCCXLVI	MD
MDXVII	CXXVIII
MDCCLXXVI	MCMXCIII
MDLXXXIX	MCCXCIV
DCCXVII	MDCCCLXXI
DCLVII	DCCXXXI
MDCLI	DLXII
MCCCVI	CCXXXI
CXII	CLXIX
MCCLXVII	CCCXCIV
CMLXXI	CCLXXXII
MCCLV	II
MCCCIV	DCCCXV
MCXLIII	CCXIX
MCDLV	MDCLXXXIII
CLXXV	CXXIX
MCCCXXXIX	MCMLXVII
MCCLIII	MCMLXXXII
MCCCXVI	DCLXXXVIII
CCCLXX	CMXCIII
MDCXXI	MCDLXI
MCLXIII	MDCCLXXV
MCIII	MCCVIII
MCLIV	MCLXXXVIII
DCXXXII	CDXLIX
MLXXXIII	MCDXCIX
MCCLXIII	CDVI
MDLXVI	CMXIX
CXI	MDLXXXI
MDCCCII	DCCCXIV
MDCXCI	XLIX
DCCCXXXV	MCCCXXXV
CMXCVIII	MDCLI
CCLXXXV	MCMLXII
MCLXXVIII	CCCXXVII
MCIV	MCCCLXI
CCXI	MLXI
MCCCXI	MCCLXXII
DCCCXIV	CCXLVIII
DCCCXCII	CMLXXXIII
MCCCXXVII	MCCCXXI
CCXXVII	CDXCII
MCXCI	DCCV
MCDLVI	CIX
MCDLI	CCCXLIX
DCCCLXVII	CDXLIII
MDLXXXVII	CMXXI
MDCCLXXII	DCXLI
DCCLXXIV	CXVII
DCCIV	MCMXCVIII
CCCXXXVII	DCXXXV
CLXXIX	MCMLXI
DLVI	XXI
CDLXXXIX	MLXXII
CMXXI	MCCCXI
MDCCCLXXVI	MCCV
CCLXXIX	DCLXXIII
MDCXLIII	MXXXVIII
DIV	MDCCXLI
CMXL	MDCXL
MCMXIII	CCLXXXIV
CLXXII	MLXXII
MDCXLVIII	MCCCLXX
MCMLVI	MDCCCXCVIII
MDVI	CMV
MCMLXXXVIII	DXCI
MDCCCXCII	MCCLXXXII
MLII	DLXVIII
DCCCXXVII	MDCCXLIV
CDXLVIII	MDCXXVII
LXVI	CMLIX
MDXCVII	MDCCCXLIII
LXXVIII	MDCCLXXIII
LXX	MCCCXXXI
CLXXXV	CLXXXIV
MDCCXXV	DLXXXVI
CDLVII	DCCCXCVI
CMXXXV	DCCXCVII
DCXIV	DCCXX
MCCLVI	MCCCLXXVIII
MCDXI	MDLIII
CCCLV	DCCLXXIV
MCXXIII	MCLXXXVI
MCXXVII	CCCLXXV
DCCCLXXI	MCCXLV
CDXCIV	DCCLXXXVIII
MCDLXXIII	MDCCLVIII
MDCXXXV	DCCCLXIII
MCMXV	DCLXXXIV
MI	DXXXVII
CDXXI	MCDVIII
MDCCLXVI	MDCXXI
MCXIV	MLVI
MDCLXVII	MCMIII
MCDXCIII	DCXX
MCDLXXX	CCXXXIII
CDXCVII	MDCCXXXVI
LXXXIV	CDXV
MDXIII	LXXIX
MDCCCLXIV	CCXCIV
DCCCLXV	DCLXXVI
MXIV	MCMVII
CLXXXVIII	MCCCLXVIII
MDLXXXVII	CDLXXXII
MCM	MCDIX
MDCCCIII	CDLXXVIII
DCCCLXVIII	XVII
CCCIX	MDCCCXCVII
MDCCCXVII	V
CCCLXIX	MCCCXXXV
CDLXXXIII	CDLIII
CCLXVIII	MCCCLXV
MLVII	MDCCXXXV
CCXXXV	MDCCCIX
DCLIX	MLXVIII
CCXIV	CCLIX
CCLXXII	DCCLXXX
MDCXCII	DCCXXIII
CMLIX	MVIII
MDXVIII	DLI
MLXXXV	MCDXXIV
MDLXXXII	CCLX
MCCCXLVI	CDXXIX
CMLIX	CCCIII
CMXXIX	MCCCXX
MCCCXXXVII	CDXCVIII
MCCV	CXXV
MCDLXXV	CCCLXIV
DCLXXIII	CDXVIII
DCCCXXXIV	MDCCLVIII
DCCLXXXVIII	CCLII
CXCII	MCCCXXXI
DCCCXX	CXCIII
CCCVIII	CXLI
MDCCXXXVIII	DCXXXV
DXVIII	DCCI
MCDXCIV	CMXVIII
CCCLXXIV	CMLXXVII
DCXXIII	MXXI
MLIV	MCXLI
DCXCIX	MDCCCLXXXVII
DCCCI	MCCCXVIII
CDLXIII	CC
MCLXXX	MDCCL
MCDLXIX	MCCCXXXVI
CCCXCV	CMLXXXV
MCMII	DCCCLVIII
MXVII	DLVII
MDXVIII	MCCCXXVII
CMLV	MDLXXI
DCCXVIII	CLXXXIII
CMXXXIV	CCCXLIV
CCXXX	MDCCCXCVII
MDCLXXIV	MDXV
MDCXIII	DCCCXXXIII
DXXXVI	CCCLXV
MDCCXL	DLXXXI
MCMXXIX	MDCCCXXXVII
MDXLIV	MDCXCVI
CIX	DCCCLXXXV
DCCXLV	V
DLXXXV	DCXXXIII
XLIII	MCMLXXXV
MDCLXXXVII	CCCXXI
MDCLXXVII	MDLXVIII
MCXCV	XCVI
DCCCXXXIX	DCCCXXX
MDCCXLVI	MDVIII
MCMXXXII	MCCXVIII
MCCCLVI	CDXLIV
MDCCXLIX	CDXXXIX
MCDIV	CCCLXXVIII
DLXXXI	MDCLXXXI
MCMXVII	MCXXIII
MDCXXXII	DCCCXCI
CIII	MDCCLXXXIV
CMLXII	CMLXXV
MCLXXX	MCXCV
MCCCXXI	MCXIV
MCCCXXXIV	MDXV
DCLXXXIV	LVI
DXXXI	DXC
MCDLXII	MDCI
MDCXXXIII	DCCXLIII
CDXII	DCCCXI
MCDLVIII	CMLXXII
CDXCI	MCCLXXII
CCCXIV	MCCCXLIV
DCCCLII	MCCXCIII
MXIV	MCCXLVIII
MDCLXXI	LXI
CXXX	CCXXIII
DCLXXIV	DCCXXXIII
DCLXXXIV	MCMLXXXIX
MDXVI	LXXVIII
CLXV	DCI
MCCCXXII	DCXXXIII
CMLXVII	MDCLXIV
MCCVIII	MCDL
LXXVI	CCLXII
CCCXCI	MCMI
MCCXCI	MDXCVII
MLXXXIII	XL
MDCLXXXI	MDCCLXXV
MDCCLVI	MDLXXI
CXV	CCXVII
CMXXI	MVII
CDXCV	MLXXVI
LVIII	CCXXX
MDCCCXIII	CCLXXVII
CXVI	MCDXXXII
MDXLIII	CDXCVIII
XVIII	DXCIX
LXI	MCXXIX
DCCCIV	MCCCLXXXVII
MCCII	DCCCXXXVIII
CCLXXXIV	DCCCLXX
XXXVII	MCMXCII
MCMLXXXIV	MDCCXCVI
MCDLXX	CXXIV
MCMLXXIII	MCCCL
MXLIII	MCCCXXXV
MDCXCVII	MCCCXIX
MCVII	VII
DXXXVIII	MCMLXXXVIII
MDCLV	LXXXIV
DCXXIV	CXCIV
MCIX	DCII
CDXCIII	MDCCCXXXV
DCCCXXXVI	CCLXXXIII
MDLXXXIII	CLXIV
LXXVII	DCCI
MDXXXVI	MCCLII
MCLXI	MCMLII
MCMXCVIII	DCCCLIV
MCMXXXI	MCCLIV
MDCCLVIII	DCCCLXXX
CMXLIV	MXXIII
CLXX	MLXXXIX
MCDX	DCCCXXX
MCDVII	MCCCLXI
CCCLVII	MCCCLXXXVI
MDCCXLVIII	MCDLXIX
CLVI	DCIII
MLXXXII	MCDLIV
MDCCXXXVII	MCI
MCLXXXVII	DXXX
CLXIX	MCCCXI
MDLIV	CCXLVII
DCCCLIV	MDC
MCCLXIII	MCLXXVII
CDXXV	CLXXXV
DCXXXIX	MCCXL
MDCLXXXIII	CCCX
MCXXIX	DCLVII
MCCLVI	MDCCLXXXVII
MCDLXIX	LXXXVI
XLVII	MDCCCXCVI
MCMIX	DCCCXXI
